0 0 0 0 0 0 0 0 147 81 81 81 81 149 0 0 0 0 0 0 0 0 0 0 0 0 0 0 0 0 0 0 
147 81 81 81 81 81 81 81 90 0 0 0 0 81 81 149 0 0 0 0 0 0 0 0 0 0 0 0 0 0 0 0 
147 0 0 0 0 0 0 0 216 0 0 0 0 0 0 90 81 149 0 0 0 0 0 0 0 0 0 0 0 0 0 0 
147 0 0 0 0 0 0 0 158 194 0 0 0 0 0 216 0 157 0 0 0 0 0 0 0 0 0 0 0 0 0 0 
147 0 0 0 0 0 0 0 157 146 193 193 193 193 193 156 0 81 149 0 0 0 0 0 0 0 0 0 0 0 0 0 
147 0 0 0 0 0 0 0 157 0 0 0 0 0 0 146 194 0 157 0 0 0 0 0 0 0 0 0 0 0 0 0 
147 0 0 0 0 0 0 0 157 0 0 0 0 0 0 0 147 225 157 0 0 0 0 0 0 0 0 0 0 0 0 0 
146 193 193 194 225 195 193 193 153 0 147 81 81 81 81 81 81 113 81 81 81 157 0 0 0 0 0 0 0 0 0 0 
0 0 0 147 113 81 81 81 81 81 90 0 0 0 0 0 0 0 0 0 0 157 0 0 0 0 0 0 0 0 0 0 
0 0 0 146 193 193 193 193 193 193 214 0 0 0 0 0 0 0 0 0 0 157 0 0 0 0 0 0 0 0 0 0 
0 0 0 0 0 0 0 0 0 0 146 193 193 193 193 193 193 194 0 0 0 157 0 0 0 0 0 0 0 0 0 0 
0 0 0 0 0 0 0 0 0 0 0 0 0 0 0 0 0 147 0 0 0 157 0 0 0 0 0 0 0 0 0 0 
0 0 0 0 0 0 0 0 0 0 0 0 0 0 0 0 0 147 0 0 0 157 0 0 0 0 0 0 0 0 0 0 
0 0 0 0 0 0 0 0 0 0 0 0 0 0 0 0 0 147 0 0 0 90 81 157 0 0 0 0 0 0 0 0 
0 0 0 0 0 0 0 0 0 0 0 0 0 0 0 0 0 147 0 0 0 216 0 81 81 157 0 0 0 0 0 0 
0 0 0 0 0 0 0 0 0 0 0 0 147 81 81 81 81 81 0 0 0 159 0 0 0 157 0 0 0 0 0 0 
0 0 0 0 0 0 0 0 0 0 0 0 147 0 0 0 0 0 0 0 0 159 0 7 0 81 81 157 0 0 0 0 
0 0 0 0 0 0 0 0 0 0 0 0 147 0 0 0 0 0 0 0 0 158 193 193 193 198 225 157 0 0 0 0 
0 0 0 0 0 0 0 0 0 0 0 0 146 194 225 195 193 193 193 193 193 153 0 0 0 147 113 81 81 81 81 157 
0 0 0 0 0 0 0 0 0 0 0 0 148 81 113 81 81 81 81 81 81 81 81 81 81 159 0 0 0 0 0 157 
0 0 0 0 0 0 0 0 0 0 0 0 147 0 195 193 193 193 194 0 0 0 0 0 0 159 0 0 0 0 0 157 
0 0 0 0 0 0 0 0 0 0 0 0 147 0 157 0 0 0 147 0 0 0 0 0 0 159 0 0 0 0 0 157 
0 0 0 0 0 0 0 0 0 0 0 0 147 0 157 0 0 0 147 0 0 0 0 0 0 159 0 0 0 0 0 157 
0 0 0 0 0 0 0 0 0 0 0 0 147 0 81 149 0 0 146 193 193 193 193 193 193 156 0 0 0 0 0 157 
0 0 0 0 0 0 0 0 0 0 0 0 146 194 0 157 0 0 0 0 0 0 0 0 0 147 0 0 0 0 0 157 
0 0 0 0 0 0 0 0 0 0 0 0 0 147 0 157 0 0 0 0 0 0 0 0 0 147 225 195 193 193 193 153 
0 0 0 0 0 0 0 0 0 0 0 0 0 147 0 157 0 0 0 0 147 81 81 81 81 81 113 157 0 0 0 0 
0 0 0 0 0 0 0 0 0 0 0 0 0 147 0 81 81 81 90 81 81 0 0 0 0 0 0 157 0 0 0 0 
0 0 0 0 0 0 0 0 0 0 0 0 0 146 193 193 193 193 214 0 0 0 0 0 0 0 0 81 157 0 0 0 
0 0 0 0 0 0 0 0 0 0 0 0 0 0 0 0 0 0 147 0 0 0 0 5 0 0 0 0 157 0 0 0 
0 0 0 0 0 0 0 0 0 0 0 0 0 0 0 0 0 0 147 0 0 0 0 5 0 0 0 0 157 0 0 0 
0 0 0 0 0 0 0 0 0 0 0 0 0 0 0 0 0 0 147 0 0 5 5 5 5 5 0 0 157 0 0 0 
0 0 0 0 0 0 0 0 0 0 0 0 0 0 0 0 0 0 147 0 0 27 27 5 27 27 0 0 157 0 0 0 
0 0 0 0 0 0 0 0 0 0 0 0 0 0 0 0 0 0 146 194 0 0 0 5 0 0 0 199 153 0 0 0 
0 0 0 0 0 0 0 0 0 0 0 0 0 0 147 81 81 81 90 81 0 0 0 0 0 0 199 153 0 0 0 0 
0 0 0 0 0 0 0 0 0 0 0 0 0 0 147 0 195 193 213 193 193 193 193 193 193 193 153 0 0 0 0 0 
0 0 0 0 0 0 0 0 0 0 0 0 0 0 147 0 157 0 0 0 0 0 0 0 0 0 0 0 0 0 0 0 
0 0 0 0 0 0 0 0 0 0 0 0 0 0 147 0 157 0 0 0 0 0 0 0 0 0 0 0 0 0 0 0 
0 0 0 0 0 0 0 0 0 0 0 0 0 0 147 0 157 0 0 0 0 0 0 0 0 0 0 0 0 0 0 0 
0 0 0 0 0 0 147 81 81 81 81 81 81 90 81 0 157 0 0 0 0 0 0 0 0 0 0 0 0 0 0 0 
0 0 0 0 0 0 147 0 0 0 0 0 0 215 193 193 153 0 0 0 0 0 0 0 0 0 0 0 0 0 0 0 
0 0 0 0 0 0 147 0 0 0 0 0 0 157 0 0 0 0 0 0 0 0 0 0 0 0 0 0 0 0 0 0 
0 0 0 0 0 0 147 0 0 0 0 0 0 157 0 0 0 0 0 0 0 0 0 0 0 0 0 0 0 0 0 0 
0 0 0 0 0 0 147 0 0 0 0 0 0 157 0 0 0 0 0 0 0 0 0 0 0 0 0 0 0 0 0 0 
0 0 0 0 0 0 146 193 193 193 193 193 193 153 0 0 0 0 0 0 0 0 0 0 0 0 0 0 0 0 0 0 
0 0 0 0 0 0 0 0 0 0 0 0 0 0 0 0 0 0 0 0 0 0 0 0 0 0 0 0 0 0 0 0
