0 0 0 0 0 0 0 0 147 0 0 0 0 149 0 0 0 0 0 0 0 0 0 0 0 0 0 0 0 0 0 0 
147 0 0 0 0 0 0 0 0 0 0 0 0 0 0 149 0 0 0 0 0 0 0 0 0 0 0 0 0 0 0 0 
147 0 0 0 0 0 0 0 212 0 0 0 0 0 0 0 0 149 0 0 0 0 0 0 0 0 0 0 0 0 0 0 
147 0 0 0 0 0 0 0 158 194 0 0 0 0 0 212 0 157 0 0 0 0 0 0 0 0 0 0 0 0 0 0 
147 0 0 0 0 0 0 0 157 146 193 193 193 193 193 156 0 0 149 0 0 0 0 0 0 0 0 0 0 0 0 0 
147 0 0 0 0 0 0 0 157 0 0 0 0 0 0 146 194 0 157 0 0 0 0 0 0 0 0 0 0 0 0 0 
147 0 0 0 0 0 0 0 157 0 0 0 0 0 0 0 147 0 157 0 0 0 0 0 0 0 0 0 0 0 0 0 
146 193 193 194 0 195 193 193 153 0 147 0 0 0 0 0 0 0 0 0 0 157 0 0 0 0 0 0 0 0 0 0 
0 0 0 147 0 0 0 0 0 0 0 0 0 0 0 0 0 0 0 0 0 157 0 0 0 0 0 0 0 0 0 0 
0 0 0 146 193 193 193 193 193 193 210 0 0 0 0 0 0 0 0 0 0 157 0 0 0 0 0 0 0 0 0 0 
0 0 0 0 0 0 0 0 0 0 146 193 193 193 193 193 193 194 0 0 0 157 0 0 0 0 0 0 0 0 0 0 
0 0 0 0 0 0 0 0 0 0 0 0 0 0 0 0 0 147 0 0 0 157 0 0 0 0 0 0 0 0 0 0 
0 0 0 0 0 0 0 0 0 0 0 0 0 0 0 0 0 147 0 0 0 157 0 0 0 0 0 0 0 0 0 0 
0 0 0 0 0 0 0 0 0 0 0 0 0 0 0 0 0 147 0 0 0 0 0 157 0 0 0 0 0 0 0 0 
0 0 0 0 0 0 0 0 0 0 0 0 0 0 0 0 0 147 0 0 0 212 0 0 0 157 0 0 0 0 0 0 
0 0 0 0 0 0 0 0 0 0 0 0 147 0 0 0 0 0 0 0 0 159 0 0 0 157 0 0 0 0 0 0 
0 0 0 0 0 0 0 0 0 0 0 0 147 0 0 0 0 0 0 0 0 159 0 0 0 0 0 157 0 0 0 0 
0 0 0 0 0 0 0 0 0 0 0 0 147 0 0 0 0 0 0 0 0 158 193 193 193 198 0 157 0 0 0 0 
0 0 0 0 0 0 0 0 0 0 0 0 146 194 0 195 193 193 193 193 193 153 0 0 0 147 0 0 0 0 0 157 
0 0 0 0 0 0 0 0 0 0 0 0 148 0 0 0 0 0 0 0 0 0 0 0 0 152 0 0 0 0 0 157 
0 0 0 0 0 0 0 0 0 0 0 0 147 0 195 193 193 193 210 0 0 0 0 0 0 159 0 0 0 0 0 157 
0 0 0 0 0 0 0 0 0 0 0 0 147 0 157 0 0 0 147 0 0 0 0 0 0 159 0 0 0 0 0 157 
0 0 0 0 0 0 0 0 0 0 0 0 147 0 157 0 0 0 147 0 0 0 0 0 0 159 0 0 0 0 0 157 
0 0 0 0 0 0 0 0 0 0 0 0 147 0 0 149 0 0 146 193 193 193 193 193 193 156 0 0 0 0 0 157 
0 0 0 0 0 0 0 0 0 0 0 0 146 194 0 157 0 0 0 0 0 0 0 0 0 147 0 0 0 0 0 157 
0 0 0 0 0 0 0 0 0 0 0 0 0 147 0 157 0 0 0 0 0 0 0 0 0 147 0 195 193 193 193 153 
0 0 0 0 0 0 0 0 0 0 0 0 0 147 0 157 0 0 0 0 147 0 0 0 0 0 0 157 0 0 0 0 
0 0 0 0 0 0 0 0 0 0 0 0 0 147 0 0 0 0 0 0 0 0 0 0 0 0 0 157 0 0 0 0 
0 0 0 0 0 0 0 0 0 0 0 0 0 146 193 193 193 193 210 0 0 0 0 0 0 0 0 0 157 0 0 0 
0 0 0 0 0 0 0 0 0 0 0 0 0 0 0 0 0 0 147 0 0 0 0 0 0 0 0 0 157 0 0 0 
0 0 0 0 0 0 0 0 0 0 0 0 0 0 0 0 0 0 147 0 0 0 0 0 0 0 0 0 157 0 0 0 
0 0 0 0 0 0 0 0 0 0 0 0 0 0 0 0 0 0 147 0 0 0 0 0 0 0 0 0 157 0 0 0 
0 0 0 0 0 0 0 0 0 0 0 0 0 0 0 0 0 0 147 0 0 0 0 0 0 0 0 0 157 0 0 0 
0 0 0 0 0 0 0 0 0 0 0 0 0 0 0 0 0 0 146 194 0 0 0 0 0 0 0 199 153 0 0 0 
0 0 0 0 0 0 0 0 0 0 0 0 0 0 147 0 0 0 0 0 0 0 0 0 0 0 199 153 0 0 0 0 
0 0 0 0 0 0 0 0 0 0 0 0 0 0 147 0 195 193 209 193 193 193 193 193 193 193 153 0 0 0 0 0 
0 0 0 0 0 0 0 0 0 0 0 0 0 0 147 0 157 0 0 0 0 0 0 0 0 0 0 0 0 0 0 0 
0 0 0 0 0 0 0 0 0 0 0 0 0 0 147 0 157 0 0 0 0 0 0 0 0 0 0 0 0 0 0 0 
0 0 0 0 0 0 0 0 0 0 0 0 0 0 147 0 157 0 0 0 0 0 0 0 0 0 0 0 0 0 0 0 
0 0 0 0 0 0 147 0 0 0 0 0 0 0 0 0 157 0 0 0 0 0 0 0 0 0 0 0 0 0 0 0 
0 0 0 0 0 0 147 0 0 0 0 0 0 211 193 193 153 0 0 0 0 0 0 0 0 0 0 0 0 0 0 0 
0 0 0 0 0 0 147 0 0 0 0 0 0 157 0 0 0 0 0 0 0 0 0 0 0 0 0 0 0 0 0 0 
0 0 0 0 0 0 147 0 0 0 0 0 0 157 0 0 0 0 0 0 0 0 0 0 0 0 0 0 0 0 0 0 
0 0 0 0 0 0 147 0 0 0 0 0 0 157 0 0 0 0 0 0 0 0 0 0 0 0 0 0 0 0 0 0 
0 0 0 0 0 0 146 193 193 193 193 193 193 153 0 0 0 0 0 0 0 0 0 0 0 0 0 0 0 0 0 0 
0 0 0 0 0 0 0 0 0 0 0 0 0 0 0 0 0 0 0 0 0 0 0 0 0 0 0 0 0 0 0 0