0 0 0 0 0 0 0 0 0 0 0 0 0 0 0 147 0 0 0 0 0 0 157 0 0 0 0 0 0 0 0 0 0 0 0 0 0 0 0 0 0 
0 0 0 0 0 0 0 0 0 0 0 147 0 0 0 0 0 0 0 0 0 0 0 0 0 0 0 157 0 0 0 0 0 0 0 0 0 0 0 0 0 
0 0 0 0 0 0 0 0 0 0 0 147 0 195 197 210 0 0 195 194 0 0 211 197 197 194 0 0 0 0 0 157 0 0 0 0 0 0 0 0 0 
0 0 0 0 0 0 0 0 0 0 0 147 0 157 0 147 0 0 157 147 0 0 157 0 0 146 197 197 197 194 0 157 0 0 0 0 0 0 0 0 0 
0 0 0 0 0 0 0 0 0 0 0 147 0 157 0 147 0 0 0 0 0 0 160 0 0 0 0 0 0 0 0 0 157 0 0 0 0 0 0 0 0 
0 0 0 0 0 0 0 0 0 0 0 147 0 157 0 147 0 0 0 0 0 0 160 0 0 0 0 0 0 0 0 0 157 0 0 0 0 0 0 0 0 
0 0 0 0 0 0 0 0 0 0 0 147 0 157 0 146 197 197 197 197 197 197 156 0 0 0 195 193 194 0 0 0 0 0 157 0 0 0 0 0 0 
0 0 0 0 0 0 0 147 0 0 0 0 0 157 0 0 0 0 0 0 0 0 147 0 0 0 0 0 0 0 0 0 212 0 157 0 0 0 0 0 0 
147 0 0 0 0 0 0 0 0 211 197 197 197 153 0 0 0 0 0 0 0 0 147 0 196 0 0 0 0 0 196 0 160 0 0 0 157 0 0 0 0 
147 0 0 0 0 0 0 0 0 160 0 0 0 0 0 0 0 0 0 0 157 0 147 0 160 0 0 0 0 0 160 0 158 197 194 0 157 0 0 0 0 
147 0 0 0 0 0 0 0 0 160 0 0 0 0 0 0 211 197 194 0 157 0 147 0 160 0 0 0 0 0 160 0 157 0 147 0 157 0 0 0 0 
147 0 0 0 0 0 0 0 0 160 0 0 195 194 0 0 157 0 147 0 157 0 147 0 0 0 0 0 0 0 0 0 160 0 0 0 0 0 0 0 157 
147 0 0 0 0 0 0 0 0 160 0 0 157 147 0 0 157 0 147 0 157 0 147 0 0 0 195 193 194 0 0 0 160 0 0 0 0 0 0 0 157 
146 197 197 197 197 197 197 197 197 156 0 0 157 147 0 0 157 0 147 0 0 0 0 0 0 0 0 0 0 0 0 0 160 0 0 0 0 0 0 0 157 
0 0 0 0 0 0 0 0 0 147 0 0 0 0 0 0 157 0 146 197 197 197 210 0 0 0 0 0 0 0 0 0 160 0 0 0 0 0 0 0 157 
0 0 0 0 0 0 0 0 0 147 0 0 0 0 0 0 157 0 0 0 0 0 146 197 197 197 197 194 0 195 197 197 156 0 0 0 0 0 0 0 157 
0 0 0 0 0 0 0 0 0 146 197 197 197 197 197 197 153 0 0 0 0 0 0 0 0 0 147 0 0 0 0 0 160 0 0 0 0 0 0 0 157 
0 0 0 0 0 0 0 0 0 0 0 0 0 0 0 0 0 0 0 0 0 0 0 0 0 0 147 0 0 0 0 0 160 0 0 0 0 0 0 0 157 
0 0 0 0 0 0 0 0 0 0 0 0 0 0 0 0 0 0 0 0 0 0 0 0 0 0 147 0 0 0 0 0 0 0 0 0 0 0 0 0 157 
0 0 0 0 0 0 0 0 0 0 0 0 0 0 0 0 0 0 0 0 0 0 0 0 0 0 146 197 194 0 0 0 211 197 197 197 197 197 197 197 153 
0 0 0 0 0 0 0 0 0 0 0 0 0 0 0 0 0 0 0 0 0 0 0 0 0 0 0 0 147 0 0 0 157 0 0 0 0 0 0 0 0 
0 0 0 0 0 0 0 0 0 0 0 0 0 0 0 0 0 0 0 0 0 0 0 0 0 0 0 0 147 0 0 0 157 0 0 0 0 0 0 0 0 
0 0 0 0 0 0 0 0 0 0 0 0 0 0 0 0 0 0 0 0 0 0 0 0 0 0 0 0 147 0 0 0 157 0 0 0 0 0 0 0 0 
0 0 0 0 0 0 0 0 0 0 0 0 0 0 0 0 0 0 0 0 0 0 0 0 0 0 0 0 146 197 197 197 153 0 0 0 0 0 0 0 0