0 0 0 0 0 0 0 0 0 0 0 0 0 0 0 0 0 0 0 0 0 0 0 0 0 0 0 0 0 0 0 0 0 0 0 0 0 0 0 0 0 
0 0 0 0 0 0 0 0 0 0 0 0 0 0 0 0 0 257 257 257 257 257 0 0 0 0 0 0 0 0 0 0 0 0 0 0 0 0 0 0 0 
0 0 0 0 0 0 0 0 0 0 0 0 0 0 0 0 257 257 257 257 257 257 0 0 0 0 0 0 0 0 0 0 0 0 0 0 0 0 0 0 0 
0 0 0 0 0 0 0 0 0 0 0 0 0 0 0 0 257 257 0 0 257 257 0 0 0 0 0 0 0 0 0 0 0 0 0 0 0 0 0 0 0 
0 0 0 0 0 0 0 0 0 0 0 0 0 0 0 0 257 257 0 0 257 257 0 0 0 0 0 0 0 0 0 0 0 0 0 0 0 0 0 0 0 
0 0 0 0 0 0 0 0 0 0 0 0 0 0 0 0 257 257 257 257 257 257 0 257 257 257 257 257 257 257 0 0 0 0 0 0 0 0 0 0 0 
0 0 0 0 0 0 0 0 0 0 0 0 0 0 0 0 257 257 257 257 257 257 0 257 257 257 257 257 257 257 257 0 0 0 0 0 0 0 0 0 0 
0 0 0 0 0 0 0 0 0 0 0 0 0 0 0 0 0 0 0 0 0 0 0 257 257 257 0 0 0 257 257 0 0 257 0 0 0 0 0 0 0 
0 0 0 0 0 0 0 0 257 0 0 0 257 0 0 0 0 0 0 0 0 0 0 257 257 257 257 257 257 257 257 0 0 0 0 0 0 0 0 0 0 
0 257 257 257 257 257 257 257 257 0 0 0 0 0 0 0 0 0 0 0 0 0 0 257 0 257 257 257 257 257 0 0 0 0 0 257 0 0 0 0 0 
0 257 257 0 0 0 257 257 257 0 257 257 257 257 0 0 0 0 257 257 0 0 0 257 0 257 257 257 257 257 0 0 0 0 0 257 0 0 0 0 0 
0 257 257 257 0 0 0 257 257 0 0 0 0 0 0 0 0 0 0 257 0 0 0 257 0 257 257 257 257 257 0 0 0 0 0 0 0 0 0 0 0 
0 257 257 0 0 0 0 0 0 0 0 0 0 0 0 0 0 0 0 257 0 0 0 257 257 257 257 257 257 257 257 0 0 0 0 257 257 257 257 257 0 
0 257 257 0 0 0 0 0 0 0 0 0 0 0 0 0 0 0 0 257 0 0 0 257 257 257 0 0 0 257 257 0 0 257 257 257 257 257 257 257 0 
0 0 0 0 0 0 0 0 0 0 0 0 0 0 0 0 0 0 0 257 257 257 0 0 257 257 257 257 257 257 257 0 0 0 257 0 0 0 257 257 0 
0 0 0 0 0 0 0 0 0 0 0 0 0 0 0 0 0 0 0 0 0 0 0 0 0 0 0 0 0 0 0 0 0 0 0 0 0 0 257 257 0 
0 0 0 0 0 0 0 0 0 0 0 0 0 0 0 257 0 0 0 0 0 0 0 0 0 0 0 0 0 0 0 0 0 0 0 0 0 0 257 257 0 
0 0 0 0 0 0 0 0 0 0 0 0 0 0 0 0 0 0 0 0 0 0 0 0 0 0 0 0 0 0 0 0 0 0 0 257 257 257 257 257 0 
0 0 0 0 0 0 0 0 0 0 0 0 0 0 0 0 0 0 0 0 0 0 0 0 0 0 0 0 257 257 257 0 0 257 257 257 257 257 257 257 0 
0 0 0 0 0 0 0 0 0 0 0 0 0 0 0 0 0 0 0 0 0 0 0 0 0 0 0 0 0 0 257 0 0 257 257 257 257 257 257 257 0 
0 0 0 0 0 0 0 0 0 0 0 0 0 0 0 0 0 0 0 0 0 0 0 0 0 0 0 0 0 0 257 0 0 0 0 0 0 0 0 0 0 
0 0 0 0 0 0 0 0 0 0 0 0 0 0 0 0 0 0 0 0 0 0 0 0 0 0 0 0 0 0 257 0 0 0 0 0 0 0 0 0 0 
0 0 0 0 0 0 0 0 0 0 0 0 0 0 0 0 0 0 0 0 0 0 0 0 0 0 0 0 0 0 257 0 0 0 0 0 0 0 0 0 0 
0 0 0 0 0 0 0 0 0 0 0 0 0 0 0 0 0 0 0 0 0 0 0 0 0 0 0 0 0 0 0 0 0 0 0 0 0 0 0 0 0