0 0 0 0 0 0 0 0 0 0 0 0 0 0 163 0 0 0 0 0 149 0 0 0 0 0 0 0 0 0 
0 0 0 0 0 0 0 0 0 0 163 0 0 0 0 0 0 0 0 0 157 0 0 0 0 0 0 0 0 0 
0 0 0 0 163 0 0 0 0 149 163 0 195 193 210 0 0 0 0 0 157 0 0 0 0 0 0 0 0 0 
0 0 0 0 163 0 0 0 0 157 163 0 157 0 163 0 0 0 0 0 157 0 0 0 0 0 0 0 0 0 
0 0 0 0 163 0 0 0 0 0 0 0 157 0 163 0 0 0 0 0 159 0 0 0 0 0 0 149 0 0 
0 0 0 0 163 0 0 0 0 211 193 193 153 0 163 0 0 0 0 0 0 0 0 0 0 0 0 157 0 0 
0 0 0 0 146 193 193 194 0 157 0 0 0 0 146 193 193 193 193 193 210 0 0 0 0 0 0 157 0 0 
0 0 0 0 0 0 0 163 0 157 0 0 0 0 0 0 0 0 0 0 163 0 0 0 0 0 0 157 0 0 
0 0 0 0 0 0 0 163 0 157 0 0 0 0 0 0 0 0 0 0 163 0 0 0 0 0 0 157 0 0 
0 0 0 0 163 0 0 0 0 157 0 0 0 0 0 0 0 0 0 0 163 0 0 0 0 0 0 157 0 0 
0 0 0 0 163 0 195 193 193 153 0 0 0 0 0 0 0 0 0 0 163 0 0 0 0 0 0 157 0 0 
0 0 0 0 163 0 157 0 0 0 0 0 0 0 0 0 0 0 0 0 163 0 0 0 0 0 0 157 0 0 
0 0 0 0 163 0 157 0 0 0 0 0 0 0 0 0 0 0 0 0 162 193 193 193 194 0 0 157 0 0 
0 0 0 0 163 0 0 0 0 157 0 147 0 0 0 0 0 0 159 0 0 0 0 0 0 0 0 0 0 149 
0 0 0 0 163 0 0 0 0 157 0 147 0 0 0 0 0 0 159 0 0 0 0 0 212 0 0 0 0 157 
0 0 0 0 163 0 0 0 0 157 0 147 0 0 0 0 0 0 159 0 0 0 0 0 159 0 0 0 0 157 
0 0 0 0 163 0 0 0 0 157 0 147 0 0 0 0 0 0 159 0 0 0 0 0 159 0 0 0 0 157 
0 0 0 0 163 0 0 0 0 157 0 147 0 0 0 0 0 0 159 0 0 0 0 0 159 0 0 0 0 157 
0 0 0 0 146 193 193 194 0 157 0 147 0 0 0 0 0 0 159 0 0 0 0 0 159 0 0 0 0 157 
0 0 0 0 0 0 0 163 0 157 0 147 0 0 0 0 0 0 158 193 193 193 193 193 156 0 195 193 193 153 
0 0 0 0 0 0 0 163 0 157 0 147 0 0 0 0 195 193 153 0 0 0 0 0 163 0 157 0 0 0 
0 0 0 0 0 0 0 163 0 0 0 0 0 0 0 0 159 0 0 0 157 0 163 0 0 0 157 0 0 0 
0 0 0 163 0 0 0 0 0 195 210 0 0 0 0 0 0 0 0 0 157 0 163 0 195 193 153 0 0 0 
0 0 0 163 0 195 193 193 193 153 163 0 0 0 0 0 212 0 0 0 0 0 0 0 157 0 0 0 0 0 
163 0 0 0 0 0 149 0 0 0 163 0 0 0 0 0 158 193 193 193 193 193 193 193 153 0 0 0 0 0 
163 0 0 0 0 0 157 0 0 0 163 0 0 0 0 0 157 0 0 0 0 0 0 0 0 0 0 0 0 0 
163 0 0 0 0 0 157 0 0 0 163 0 0 0 0 0 157 0 0 0 0 0 0 0 0 0 0 0 0 0 
163 0 0 0 0 0 157 0 0 0 146 193 193 193 193 193 153 0 0 0 0 0 0 0 0 0 0 0 0 0 
163 0 0 0 0 0 157 0 0 0 0 0 0 0 0 0 0 0 0 0 0 0 0 0 0 0 0 0 0 0 
163 0 0 0 0 0 157 0 0 0 0 0 0 0 0 0 0 0 0 0 0 0 0 0 0 0 0 0 0 0 
146 193 193 193 193 193 153 0 0 0 0 0 0 0 0 0 0 0 0 0 0 0 0 0 0 0 0 0 0 0